; 0
##########
##########
#  #######
#   ######
# $     .#
#.$ @    #
#        #
## ##   ##
##### ####
##########
