; 0
##########
###   ####
##.@$  ###
#  $    ##
#.   ## ##
### ### ##
#        #
#   ######
#   ######
##########
