; 0
#######
# # # #
#  .  #
####  #
## $$.#
#@    #
#######