%%%%%%%
% G   %
%P.   %
%  G  %
%   G %
%     %
%%%%%%%
