%%%%%
% G %
%P. %
%   %
%%%%%
