%%%%%%%
% G   %
%P.   %
%  G  %
%     %
%     %
%%%%%%%
