%%%%%
% G %
%P. %
%%%%%
%%%%%
