%%%%%%%
% G   %
%P.   %
%     %
%     %
%     %
%%%%%%%
