%%%%%%%%%%%
%.....P...%
%.%.%.%.%.%
%%%.%.%.%%%
%%%.....%%%
%%%.%.%.%%%
%.%.%.%.%.%
%.....G...%
%%%%%%%%%%%