%%%%%%%%
%......%
%.%%%%.%
%G.%...%
%.%%%%P%
%......%
%%%%%%%%