%%%%%%%%%
%%%%%%%%%
%%%%%%%%%
%   G   %
%P     .%
%%%%%%%%%
%%%%%%%%%
%%%%%%%%%
%%%%%%%%%