%%%%%%
% G %%
%P. %%
%   %%
%   %%
%%%%%%
