%%%%%%%%%%
%P      .%
%%%%%%%%%%