; 0
##########
#   @    #
#        #
# $      #
#.      .#
####### $#
#######  #
#######  #
##########
##########
