%%%%%%%%%%%%%%%%%%%
%....%.......%....%
%.%%.%.%%%%%.%.%%.%
%.%......P......%.%
%.%.%%.%%.%%.%%.%.%
%......%GGG%......%
%.%.%%.%%.%%.%%.%.%
%.%.............%.%
%.%%.%.%%%%%.%.%%.%
%....%.......%....%
%%%%%%%%%%%%%%%%%%%
