%%%%%%%%%%%%%%%%%%%%%%%%%%%%%
%............%%%............%
%.%%%%.%%%%%.%%%.%%%%%.%%%%.%
%.%%%%.%%%%%.%%%.%%%%%.%%%%.%
%.%%%%.%%%%%.%%%.%%%%%.%%%%.%
%...........................%
%.%%%%.%%.%%%%%%%%%.%%.%%%%.%
%.%%%%.%%.%%%%%%%%%.%%.%%%%.%
%......%%....%%%....%%......%
%%%%%%.%%%%%.%%%.%%%%%.%%%%%%
%%%%%%.%%%%%.%%%.%%%%%.%%%%%%
%%%%%%.%.............%.%%%%%%
%%%%%%.% %%%%%.%%%%% %.%%%%%%
%........%..GGGG...%........%
%%%%%%.% %%%%%.%%%%% %.%%%%%%
%%%%%%.%.............%.%%%%%%
%%%%%%.%%%%%.%%%.%%%%%.%%%%%%
%%%%%%.%%%%%.%%%.%%%%%.%%%%%%
%......%%....%%%....%%......%
%.%%%%.%%.%%%%%%%%%.%%.%%%%.%
%.%%%%.%%.%%%%%%%%%.%%.%%%%.%
%...........................%
%.%%%%.%%%%%.%%%.%%%%%.%%%%.%
%.%%%%.%%%%%.%%%.%%%%%.%%%%.%
%.%%%%.%%%%%.%%%.%%%%%.%%%%.%
%............%%%P...........%
%%%%%%%%%%%%%%%%%%%%%%%%%%%%%