%%%%%%%
%  .  %
% %%% %
% %%% %
%G%%% %
%P    %
%%%%%%%