%%%%%%%%%%%%%%%%%%%
%%%%.....%.....%%%%
%....%%%...%%%....%
%.%%...%%.%%...%%.%
%.%..%...GG..%..%.%
%.%%.%.%%%%%.%.%%.%
%P................%
%%%%%%%%%%%%%%%%%%%
