; 0
##########
###   ####
##.@$  ###
#        #
#        #
#  $ #####
#.   #####
#   ######
#  #######
##########
